111111111111111111111111111111111111111111
100000000000000000000000000000000000000001
111111111111111111111111111111111111111101
101000000000000000001000000000000000000101
101000000000000000001000000000000000000101
101000000000000000001000000000000000000101
101000000000000000001000000000000000000101
101000000000000000001000000000000000000101
101000000000000000001000000000000000000101
101000000000000000001000000000000000000101
101000000000000000001000000000000000000101
101000000000000000001000000000000000000101
101000000000000000001000000000000000000101
101000000000000000001000000000000000000101
101000000000000000001000000000000000000101
101000000000000000001000000000000000000101
101000000000000000001000000000000000000101
101000000000000000001000000000000000000101
101000000000000000001000000000000000000101
101000000000000000001000000000000000000101
101000000000000000001000000000000000000101
101111111111111111111111111111111111111101
101000000000000000001000000000000000000101
101000000000000000001000000000000000000101
101000000000000000001000000000000000000101
101000000000000000001000000000000000000101
101000000000000000001000000000000000000101
101000000000000000001000000000000000000101
101000000000000000001000000000000000000101
101000000000000000001000000000000000000101
101000000000000000001000000000000000000101
101000000000000000001000000000000000000101
101000000000000000001000000000000000000101
101000000000000000001000000000000000000101
101000000000000000001000000000000000000101
101000000000000000001000000000000000000101
101000000000000000001000000000000000000101
101000000000000000001000000000000000000101
101000000000000000001000000000000000000101
101111111111111111111111111111111111111111
100000000000000000000000000000000000000001
111111111111111111111111111111111111111111